5 0 0 3 0 0 0 4 0 0 3 0 0 0 4 0 0 3 0 0 0 4 0 0 3 0 0 0 8
14 2 2 11 2 2 2 2 9 2 2 2 2 2 2 2 2 2 9 2 2 2 2 2 2 2 2 2 13
14 9 2 2 2 2 2 2 2 2 2 2 2 12 2 2 2 2 2 2 2 2 2 9 2 2 2 2 13
14 2 2 2 2 2 10 2 2 2 2 2 2 2 2 2 2 2 2 2 11 2 2 2 2 2 2 2 13
14 2 12 2 2 2 2 2 2 9 2 2 2 2 10 2 2 2 2 2 2 2 2 11 2 2 2 2 13
14 2 2 2 2 2 9 2 2 2 2 2 2 2 2 2 2 2 2 2 2 2 2 2 2 2 9 2 13
14 2 2 2 2 2 11 2 2 10 2 2 2 2 2 2 2 2 2 2 2 2 2 2 2 2 2 2 13
14 2 2 9 2 2 2 2 2 2 2 2 9 2 2 2 2 2 2 11 2 2 2 2 2 2 2 2 13
14 2 2 2 2 2 2 9 2 2 2 2 2 2 2 2 2 2 2 2 2 2 2 2 2 12 2 2 13
6 15 15 15 15 15 15 15 15 15 15 15 15 15 15 15 15 15 15 15 15 15 15 15 15 15 15 15 7